#########################
#     #                 #
#  #  #  ####  ##########
#  #     #        #     #
####S ####  #  ####  ####
#        #  #           #
#  ######################
#     #     #           #
####  ####  #  ##########
#        #  #  #        #
#  ####  #  #  #  ####  #
#     #  #     #  #     #
#  ####  ####  #  ####  #
#  #              #     #
####  ####  ####  ####  #
#        #     #  #     F
#########################