##F############################
#                       #  #  #
#  ###################  #  #  #
#           #        #        #
####  #  #  ####  #  #  #######
#  #  #  #  #  #  #        #  #
#  #  #  ####  #######  ####  #
#     #  #     #  #           #
#######  #  ####  #  #######  #
#  #     #     #        #     #
#  ####  #  ####  ##########  #
#              #  #           #
#  ###################  #######
#        #  #           #     #
#  #  ####  #  ####  #  #  #  #
#  #     #     #     #     #  #
#  #######  ################  #
#        #  #     #  #        #
#  #  ##########  #  #######  #
#  #  #S                      #
###############################