################
#              F
#  ####  #######
#     #  #     #
#  ####  #  #  #
#     #     #  #
#######  ####  #
#S #     #     #
#  ##########  #
#           #  #
################