################
#              F
#  ####  #######
#     #  #     #
#  ####  #  #  #
#     #     #  #
#######  ####  #
#S #     #     #
#  ####  ####  #
#           #  #
################